khushboo	खुशबू
khushbuu	खुशबू
khushbu	खुशबू
khusbhu	खुशबू
tera	तेरा
teraa	तेरा
thera	तेरा
teraaa	तेरा
badan	बदन
sulgeh	सुलगे
sulage	सुलगे
sulge	सुलगे
mehke	महके
mahake	महके
mehake	महके
maheke	महके
pighale	पिघले
pighle	पिघले
dehke	दहके
dahake	दहके
behke	बहके
baheke	बहके
bahake	बहके
behake	बहके
bahke	बहके
mera	मेरा
meraa	मेरा
meraaa	मेरा
chali	चली
chalii	चली
challi	चली
chale	चली
hawaa	हवा
hawa	हवा
hava	हवा
havaa	हवा